1
W map2 E
0 0 0 0 0 0 0 0 0 0 0 0 0 0 0 0
0 1 1 1 1 1 1 1 1 1 1 1 1 1 1 0
0 1 1 0 0 1 1 1 1 1 1 1 1 1 1 0
0 1 1 0 0 1 1 1 1 1 1 1 1 1 1 0
0 1 1 0 0 1 1 1 1 1 1 1 1 1 1 0
W 1 1 0 0 1 1 1 1 1 1 1 1 1 1 0
W 1 1 0 0 1 1 1 1 1 1 1 1 1 1 0
0 1 1 0 0 1 1 1 1 1 1 1 1 1 1 0
0 1 1 0 0 0 0 0 0 0 0 1 1 1 1 0
0 1 1 0 0 0 0 0 0 0 0 1 1 1 1 0
0 1 1 1 1 1 1 1 1 1 1 1 1 1 1 0
0 0 0 0 0 0 0 0 0 0 0 0 0 0 0 0